11111111111111111111
10001110001000000021
10100000100011111101
10101110101000101101
10100010101010000001
10111010101010111111
10001000100010000001
10100010101000111101
10101010001000100001
10111111111011101111
10100000000000100001
10001010101111101101
10101000100000000001
10111011111110111111
10000000000000000101
10011010101010101101
10010010100000100001
10110110101110111111
13000000100000000001
11111111111111111111