11111111111111111111
10100010100101000001
10110110101000111101
10000000000000000001
10111110101011111011
10000010110000010101
10000010100000000001
10111110121011111011
10100011111010110001
10001000000010000001
10111111111111111101
10000000030000000001
10100010101001001011
10010010100000000001
10110110101000111101
10000000000000000001
10111110101011111011
10000010110000010101
11111111111111111111