1111111111
1010001021
1001001011
1101101011
1000000001
1011111011
1000001011
1011111011
1310000001
1111111111