1111111111
1000000021
1000000001
1000000001
1000000001
1001111001
1000031001
1001111001
1000000001
1111111111